About=About
AboutSearcher=About Searcher
Administrator=Administrator
All=All
AlwaysExcluded=Always Excluded
Any=Any
ArchiveFileExclusionNotAllowed=Unable to exclude file. Archived or zipped files cannot be excluded. To be handled in a future version.
Cancel=Cancel
ClickAboutForUpdates=Click 'About' for updates
CopyAll=Copy All
CopyFileName=Copy file name
CopyFileNameNoExtension=Copy file name (without extension)
CopyFullPath=Copy full path
Copyright=Copyright Â©
CreatePreferencesFileQuestion=No search preferences found. Do you want to save your search preferences?
Directory=Directory
DirectoryPathNotFound=Unable to access directory path(s) or path(s) cannot be found
DistributeSoftware=This is free software, and you are welcome to redistribute it under certain conditions. See the
Editor=Editor
EndDate=End Date
ErrorOccurred=Error occurred
ExcludeArchiveAsFile=Cannot exclude. If this is an archive, please exclude it as a file.
ExcludeDirectory=Exclude directory from search
ExcludeFileAlways=Always exclude file from search
ExcludeFileTemporarily=Exclude file from search temporarily
ExclusionType=Exclusion type
ExecutableFiles=Executable Files
Files=file(s)
FilesFound=Files found
Filters=Filters
ForDetails=for details
Found=Found
GetFilesToSearch=Getting files to search
GettingFilesToSearch=Getting files to search
GNULicenceLink=GNU licence link
HighlightResults=Highlight results
In=in
Language=Language
MatchCase=Match case
Matches=Match(es)
MatchOptions=Match Options
Misc=Misc
MonthlyUpdateCheck=Check for updates (monthly)
Multiline=Multiline?
Normal=Normal
NoSearchPreferences=No search preferences
Of=of
OpenDirectoryInExplorer=Open containing directory in explorer
OpenPreferencesFile=Open preferences file
Options=Options
Permanent=Permanent
PopOutResults=Pop out results
PreferencesFileLoadFailure=Unable to load preferences file
ProcessingFiles=Processed Files
Regex=Regex
Results=Results
ResultsPopout=Results Popout
SaveResultsToFile=Save all results to file
Search=Search
SearchCancelled=Search cancelled
SearchComplete=Search complete
SearchedFileList=Searched File List
Searching=Searching
SearchMode=Search Mode
SearchTerm=Search Term
SelectDate=Select a date
SelectDirToExclude=Select directory to exclude
SelectEditor=Select editor
SeparateUsingCharacter=Separate additional entries by using the character
SpecifySearchDirectory=Please specify directory and contents to search.
StartDate=Start Date
StartDateLessThanEndDateError=Start date cannot be later than end date.
Subfolders=Subfolders
TemporarilyExcluded=Temporarily Excluded
Temporary=Temporary
TimeToSearch=Time taken to get files and search
TooltipChangeLanguage=Change language
TooltipEditorForFile=Editor for opening files
TooltipFileCreateEndDate=File Creation (End Date)
TooltipFileCreateStartDate=File Creation (Start Date)
TooltipHighlightMatches=Highlight background in the resulting matches.
TooltipMatchCase=Case sensitive match.
TooltipMatchWholeWord=Match whole word
TooltipNormalSearch=Default search mode
TooltipOpenSearchedFileList=Open searched file list
TooltipSearchRegex=Search using regular expressions
TooltipSearchRegexMultiLine=Regular expression search over multiple lines
TooltipSearchSubfolders=Search within subfolders.
UnknownAssemblyName=Unknown Assembly Name
Update=Update
UseConfigDelimiterCharacter=If using a specific character separator via configuration, please ensure it is used when searching.
WarrantyText=This program comes with ABSOLUTELY NO WARRANTY.
WholeWord=Whole Word
