About=Über
AboutSearcher=Über Searcher
Administrator=Administrator
All=Alle
AlwaysExcluded=Immer ausgeschlossen
Any=Irgendein
ArchiveFileExclusionNotAllowed=Datei kann nicht ausgeschlossen werden. Archivierte oder komprimierte Dateien können nicht ausgeschlossen werden. In einer zukünftigen Version zu behandeln.
Cancel=Stornieren
ClickAboutForUpdates=Klicken Sie auf 'Über', um Updates zu erhalten
CopyAll=Kopiere alles
CopyFileName=Kopieren Sie den Dateinamen
CopyFileNameNoExtension=Dateinamen kopieren (ohne Endung)
CopyFullPath=Kopieren Sie den vollständigen Pfad
Copyright=Urheberrechte ©
CreatePreferencesFileQuestion=Keine Sucheinstellungen gefunden. Möchten Sie Ihre Sucheinstellungen speichern?
Directory=Verzeichnis
DirectoryPathNotFound=Zugriff auf Verzeichnis Pfad nicht möglich oder Pfad nicht gefunden
DistributeSoftware=Dies ist freie Software, die Sie unter bestimmten Bedingungen gerne weitergeben können. Siehe die
Editor=Anwendung bearbeiten
EndDate=Enddatum
ErrorOccurred=Ein Fehler ist aufgetreten
ExcludeArchiveAsFile=Kann nicht ausschließen. Wenn dies ein Archiv ist, schließen Sie es bitte als Datei aus.
ExcludeDirectory=Verzeichnis von der Suche ausschließen
ExcludeFileAlways=Datei immer von der Suche ausschließen
ExcludeFileTemporarily=Datei vorübergehend von der Suche ausschließen
ExclusionType=Ausschlusstyp
ExecutableFiles=Ausführbare Dateien
Files=datei (en)
FilesFound=Dateien gefunden
Filters=Filter
ForDetails=für Details
Found=Gefunden
GetFilesToSearch=Holen Sie sich Dateien zu Suchen
GettingFilesToSearch=Holen Sie sich Dateien zum Suchen
GNULicenceLink=GNU-Lizenzlink
HighlightResults=Ergebnisse hervorheben
In=im
Language=Sprache
MatchCase=Groß- und Kleinschreibung
Matches=zusammenpassen (e)
MatchOptions=Übereinstimmungsoptionen
Misc=Sonstiges
MonthlyUpdateCheck=Nach Updates suchen (monatlich)
Multiline=Mehrzeilig?
Normal=Normal
NoSearchPreferences=Keine Sucheinstellungen
Of=von
OpenDirectoryInExplorer=Verzeichnis im Explorer öffnen
OpenPreferencesFile=Öffnen Sie die Einstellungsdatei
Options=Optionen
Permanent=Permanenten
PopOutResults=Pop-Out-Ergebnisse
PreferencesFileLoadFailure=Voreinstellungsdatei kann nicht geladen werden
ProcessingFiles=Dateien verarbeitung
Regex=Regex-muster
Results=Ergebnisse
ResultsPopout=Ergebnisse Popout
SaveResultsToFile=Speichern Sie alle Ergebnisse in einer Datei
Search=Suche
SearchCancelled=Suche abgebrochen
SearchComplete=Suche abgeschlossen
SearchedFileList=Liste der durchsuchen Dateien
Searching=Suchen
SearchMode=Suchmodus
SearchTerm=Suchbegriff
SelectDate=Datum auswählen
SelectDirToExclude=Verzeichnis zum Ausschließen auswählen
SelectEditor=Editor auswählen
SeparateUsingCharacter=Trennen Sie zusätzliche Einträge mit dem Zeichen
SpecifySearchDirectory=Bitte geben Sie das Verzeichnis und den Inhalt an, nach denen gesucht werden soll.
StartDate=Startdatum
StartDateLessThanEndDateError=Das Startdatum darf nicht nach dem Enddatum liegen.
Subfolders=Unterverzeichnis
TemporarilyExcluded=Vorübergehend ausgeschlossen
Temporary=Befristete
TimeToSearch=Zeit, um Dateien abzurufen und zu suchen
TooltipChangeLanguage=Sprache ändern
TooltipEditorForFile=Editor zum Öffnen von Dateien
TooltipFileCreateEndDate=Dateierstellung (Enddatum)
TooltipFileCreateStartDate=Dateierstellung (Startdatum)
TooltipHighlightMatches=Markieren Sie den Hintergrund in den resultierenden Übereinstimmungen.
TooltipMatchCase=Groß- und Kleinschreibung beachten.
TooltipMatchWholeWord=Ganze Wort
TooltipNormalSearch=Standard Suchmodus
TooltipOpenSearchedFileList=Liste der durchsuchten Dateien öffnen
TooltipSearchRegex=Suche mit regulären Ausdrücken
TooltipSearchRegexMultiLine=Suche nach regulären Ausdrücken über mehrere Zeilen
TooltipSearchSubfolders=Suche in Unterordnern.
UnknownAssemblyName=Unbekannter Assemblyname
Update=aktualisieren
UseConfigDelimiterCharacter=Wenn Sie ein bestimmtes Zeichen Trennzeichen über die Konfiguration verwenden, stellen Sie sicher, dass es bei der Suche verwendet wird.
WarrantyText=Dieses Programm kommt mit ABSOLUT KEINER GARANTIE.
WholeWord=Ganze Wort
